50
15
1
1
199 199 199 199 1 1 1 1 1 1 1 1 1 1 1 1 1 1 1 1 1 1 1 1 1 1 1 1 1 1 1 1 199 199 199 199 199 199 199 199 199 199 199 199 199 199 199 199 199 199 
199 199 199 199 1 0 0 0 0 0 0 0 0 0 0 0 0 0 0 0 0 0 0 0 0 0 0 0 0 0 1 1 199 199 199 199 199 199 199 199 199 199 199 199 199 199 199 199 199 199 
199 199 199 199 1 0 0 0 0 0 0 0 0 0 0 0 0 0 0 0 0 0 0 0 0 0 0 0 0 0 0 1 1 199 199 199 199 199 199 199 199 199 199 199 199 199 199 199 199 199 
199 199 199 199 1 0 0 0 0 0 0 0 0 0 0 0 0 0 0 0 0 0 0 0 0 0 0 0 0 0 0 0 1 1 199 199 199 199 199 199 199 199 199 199 199 199 199 199 199 199 
199 199 199 1 1 0 0 0 18 0 0 0 0 0 0 0 0 0 0 0 0 0 0 0 0 0 0 0 0 0 0 0 0 1 1 199 199 199 199 199 199 199 199 199 199 199 199 199 199 199 
1 1 1 1 1 17 17 1 1 1 0 0 0 0 0 0 0 0 0 0 0 0 0 0 0 0 0 0 0 0 0 0 0 0 1 1 199 199 199 199 199 199 199 199 199 199 199 199 199 199 
1 1 1 1 0 0 0 1 1 1 0 0 0 0 0 0 0 0 0 0 0 0 0 0 0 0 0 0 0 0 0 0 0 0 1 1 1 199 199 199 199 199 199 199 199 199 199 199 199 199 
1 1 1 0 0 0 0 1 1 1 0 0 0 0 0 0 0 0 0 0 0 0 0 0 0 0 0 0 0 0 1 15 2 0 1 1 1 1 199 199 199 199 199 199 199 199 199 199 199 199 
1 1 1 16 16 1 3 1 1 1 0 0 0 0 0 2 16 16 2 0 0 0 0 0 0 0 0 0 0 0 1 0 0 0 1 1 1 1 1 199 199 199 199 199 199 199 199 199 199 199 
1 0 0 0 0 1 1 1 1 0 0 0 0 0 0 0 0 0 0 0 0 0 0 0 0 2 15 3 2 0 1 0 2 16 1 1 1 1 1 1 199 199 199 199 199 199 199 199 199 199 
1 0 0 0 0 1 1 1 1 3 2 15 15 2 0 0 0 0 0 2 17 7 17 2 0 0 0 0 0 0 1 0 0 0 15 0 0 0 1 1 199 199 199 199 199 199 199 199 199 199 
1 15 15 1 3 1 1 1 1 1 0 0 0 0 0 0 0 0 0 0 0 0 0 0 0 0 0 0 0 0 1 17 2 0 15 0 0 0 0 1 199 199 199 199 199 199 199 199 199 199 
1 0 0 1 1 1 1 1 1 1 0 0 0 0 0 0 0 0 0 0 0 0 0 0 0 0 0 0 0 0 1 0 0 0 1 1 0 0 0 1 199 199 199 199 199 199 199 199 199 199 
1 0 0 1 1 1 1 1 1 1 9 9 9 9 9 9 9 9 9 9 9 9 9 9 9 9 9 9 9 9 1 9 9 9 1 1 4 4 4 1 199 199 199 199 199 199 199 199 199 199 
1 1 3 1 1 1 1 1 1 1 1 1 1 1 1 1 1 1 1 1 1 1 1 1 1 1 1 1 1 1 1 1 1 1 1 1 1 1 1 1 199 199 199 199 199 199 199 199 199 199 
