50
15
1
1
1 1 1 1 1 1 1 1 1 1 1 1 1 1 1 1 1 1 1 1 1 1 1 1 1 1 1 1 1 1 199 199 199 199 199 199 1 1 1 1 1 1 1 1 1 1 1 1 1 1 
1 0 0 0 15 0 0 0 1 15 6 6 15 1 0 0 1 0 0 0 0 0 0 0 0 0 0 0 0 1 199 199 199 199 199 199 1 5 1 0 0 0 0 0 0 0 0 0 0 1 
1 0 0 0 1 0 0 0 1 15 15 15 15 1 0 0 1 0 23 0 0 0 0 0 0 0 0 19 0 1 199 199 199 199 199 199 1 5 1 1 0 0 0 1 0 1 0 1 0 1 
1 0 0 0 1 0 0 0 1 15 17 16 17 1 0 0 1 1 1 1 1 1 0 0 0 0 7 1 0 1 199 199 199 199 199 199 1 5 1 0 0 0 0 0 0 0 0 1 0 1 
1 0 0 0 1 0 0 0 1 15 16 16 17 1 0 0 1 0 20 0 9 1 9 9 9 9 1 0 0 1 199 199 199 199 199 199 1 5 1 0 3 0 0 0 0 0 1 1 0 1 
1 0 0 0 1 0 0 0 1 15 1 1 17 1 0 0 1 0 1 0 1 1 1 1 1 1 1 0 0 1 199 199 199 199 199 199 1 5 1 0 0 0 0 0 1 0 0 1 0 1 
1 0 0 0 1 0 0 0 1 15 15 16 16 1 0 0 1 0 1 0 0 0 0 0 0 0 0 0 3 1 199 199 199 199 199 199 1 5 1 0 0 1 0 0 0 0 0 1 0 1 
1 0 0 0 1 0 0 0 1 17 17 17 17 1 0 0 1 0 1 1 1 1 1 1 1 1 1 1 1 1 199 199 199 199 199 199 1 5 1 0 0 0 0 0 0 0 0 1 0 1 
1 3 0 0 1 0 0 0 1 17 8 17 17 1 0 0 1 0 0 0 0 0 0 0 0 0 0 0 0 1 1 1 1 1 1 1 1 1 1 1 0 0 0 0 7 0 0 1 0 1 
1 1 16 1 1 0 0 0 1 15 16 16 15 1 0 0 1 3 1 16 1 1 1 1 1 16 1 1 16 1 0 0 0 0 0 0 1 0 17 0 0 0 0 0 0 0 0 1 0 1 
1 0 0 0 0 0 0 0 0 0 0 0 0 0 0 0 1 1 1 0 0 0 0 0 0 0 0 0 0 0 0 0 0 0 0 0 1 0 17 9 0 0 0 0 0 0 3 1 0 1 
1 0 0 0 0 0 0 0 0 0 0 0 0 0 0 0 0 0 0 0 0 0 0 0 0 0 0 0 0 0 0 0 0 0 0 0 1 0 1 1 0 0 0 0 1 0 0 1 0 1 
1 0 0 0 0 0 0 0 0 0 0 0 0 0 0 0 0 0 0 0 0 0 0 0 0 0 0 0 0 0 0 0 0 0 0 0 16 0 15 0 0 0 0 0 0 0 0 1 0 1 
1 0 3 0 0 0 0 0 0 3 0 0 0 0 0 3 0 0 0 0 0 3 0 0 21 0 0 0 3 0 0 0 0 0 10 0 16 0 15 1 9 9 9 9 9 9 9 1 4 1 
1 1 1 9 9 1 1 1 9 1 9 1 1 1 9 1 9 1 1 9 9 1 9 1 1 1 1 9 1 9 9 1 1 1 1 1 1 3 1 1 1 1 1 1 1 1 1 1 1 1 
