50
15
1
1
199 199 199 199 199 199 199 199 199 199 199 199 199 199 199 199 199 199 199 199 199 199 199 199 199 199 199 199 199 199 199 199 199 199 199 199 199 199 199 199 199 199 199 199 199 199 199 199 199 199 
199 199 199 199 199 199 199 199 199 199 199 199 199 199 199 199 199 199 199 199 199 199 199 199 199 199 199 199 199 199 199 199 199 199 199 199 199 199 199 199 199 199 199 199 199 199 199 199 199 199 
199 199 199 199 199 199 199 199 199 199 199 199 199 199 199 199 199 199 199 199 199 199 199 199 199 199 199 199 199 199 199 199 199 199 199 199 199 199 199 199 199 199 199 199 199 199 199 199 199 199 
199 199 199 199 199 199 199 199 199 199 199 199 199 199 199 199 199 199 199 199 199 199 199 199 199 199 199 199 199 199 199 199 199 199 199 199 199 199 199 199 199 199 199 199 199 199 199 199 199 199 
199 199 199 199 199 199 199 199 199 199 1 1 1 1 1 1 1 1 1 1 1 1 1 1 1 1 1 1 1 1 1 1 1 1 1 1 1 1 1 1 1 1 1 199 199 199 199 199 199 199 
199 199 199 199 199 199 199 199 199 199 1 0 0 0 0 0 0 0 0 0 0 0 0 0 0 0 0 0 0 0 0 0 0 0 0 0 0 0 0 0 1 0 1 1 199 199 199 199 199 199 
199 199 199 199 199 199 199 199 199 1 1 0 0 0 0 0 0 0 0 0 0 0 0 0 0 0 0 0 0 0 0 0 0 0 0 0 0 0 0 0 1 0 0 1 1 199 199 199 199 199 
199 199 199 199 199 199 1 1 1 1 1 0 0 0 0 0 0 0 0 0 0 0 0 0 0 0 0 0 1 1 7 1 0 0 0 0 0 0 0 0 1 0 0 0 1 1 199 199 199 199 
199 199 199 199 199 1 1 0 0 0 1 0 0 0 0 0 0 0 0 0 0 0 0 0 0 0 0 0 1 1 1 1 0 0 0 0 0 0 0 0 16 0 0 0 0 1 1 199 199 199 
199 199 199 199 1 1 0 0 0 0 1 0 0 0 0 0 0 0 0 0 0 0 0 0 0 0 0 0 1 1 1 1 0 0 0 0 0 0 0 0 16 0 0 0 0 0 1 199 199 199 
199 199 199 199 1 0 0 0 0 0 15 0 0 0 0 0 0 0 0 0 0 0 0 0 0 0 1 3 1 1 1 1 0 0 0 0 0 0 0 0 16 0 0 0 0 0 1 199 199 199 
1 1 1 1 1 0 0 0 0 0 15 0 0 0 0 0 1 17 17 2 2 16 16 1 0 0 1 1 1 1 1 1 0 0 0 0 0 0 0 0 1 0 0 0 0 0 1 199 199 199 
1 0 0 0 1 0 0 0 0 0 1 15 15 15 15 15 1 0 0 0 0 0 0 1 9 9 1 1 1 1 1 1 0 0 0 0 0 0 0 0 1 0 0 0 0 0 1 199 199 199 
1 0 10 0 17 0 11 0 0 0 1 9 9 9 9 9 1 9 9 9 9 9 9 1 1 1 1 1 1 1 1 1 0 0 0 0 0 0 0 0 1 0 0 0 0 0 1 199 199 199 
1 1 1 1 1 2 2 3 2 2 1 1 1 1 1 1 1 1 1 1 1 1 1 1 1 1 1 1 1 1 1 1 9 9 9 9 9 9 9 9 1 1 1 1 4 1 1 199 199 199 
