50
15
1
1
1 1 1 1 1 1 1 1 1 1 1 1 1 1 1 1 1 1 1 1 1 1 1 1 1 1 1 1 1 1 1 1 1 1 1 1 1 1 1 1 1 1 1 1 1 1 1 1 1 1 
1 0 0 0 0 0 0 0 0 0 0 0 0 0 0 0 0 0 0 0 0 0 0 0 0 0 0 0 0 0 0 0 0 0 0 0 0 0 0 0 0 0 0 0 0 0 0 0 0 1 
1 0 0 0 0 0 0 0 0 0 0 0 0 0 0 0 0 0 0 0 0 0 0 0 0 0 0 0 0 0 0 0 0 0 9 9 9 9 9 9 9 9 9 9 9 9 9 9 9 1 
1 0 0 0 0 0 0 0 0 0 0 0 0 0 0 0 0 0 0 0 0 0 0 0 0 0 3 7 0 2 2 2 15 15 2 2 2 2 2 2 2 2 2 2 2 2 2 2 2 1 
1 0 0 0 0 0 0 0 0 0 1 1 1 1 1 1 1 1 1 1 1 1 1 1 8 0 0 1 0 0 0 2 0 0 0 16 16 17 16 16 0 0 0 0 0 0 0 0 0 1 
1 0 0 0 0 0 0 0 0 0 1 0 0 0 0 0 0 0 0 0 0 0 0 1 1 0 0 1 0 0 0 2 0 0 0 15 15 15 15 15 0 0 0 0 0 0 0 0 0 1 
1 0 0 0 0 0 0 0 0 0 1 0 0 1 1 1 1 1 1 1 20 0 0 0 1 0 0 1 3 0 2 2 2 7 2 2 2 2 2 2 2 2 2 2 2 2 2 2 0 1 
1 0 0 0 0 0 0 0 0 0 1 1 0 1 0 0 0 0 0 1 2 2 2 17 1 0 0 1 0 0 0 2 0 0 0 16 15 17 17 17 15 16 0 0 0 0 19 0 0 1 
1 0 0 0 0 0 0 0 0 0 0 1 0 0 0 0 0 0 0 0 0 0 1 17 1 0 0 1 0 2 2 2 0 2 2 2 2 2 2 2 2 2 2 7 2 2 2 2 8 1 
1 0 0 0 9 0 0 0 0 0 0 1 0 0 0 0 0 0 0 21 0 0 1 17 1 0 0 1 0 0 0 2 0 0 21 0 16 0 15 0 17 0 15 0 16 0 0 0 0 1 
1 0 0 18 1 0 0 0 0 0 0 1 3 1 7 0 0 7 3 1 0 0 1 17 1 0 0 1 0 0 0 2 2 2 2 7 2 7 2 7 2 7 2 7 2 2 2 2 0 1 
1 0 1 1 1 0 0 0 0 0 0 1 1 1 0 0 0 0 1 0 0 3 1 17 0 0 0 1 3 2 0 2 0 0 0 0 0 0 0 0 0 0 0 0 0 0 0 0 0 1 
1 0 0 0 17 0 0 0 0 0 0 15 16 17 0 0 0 19 0 0 0 1 0 0 0 0 0 15 0 0 0 2 0 0 0 0 0 0 0 0 20 0 0 0 0 0 0 0 0 1 
1 0 0 0 17 0 0 20 0 0 0 1 1 1 1 0 0 1 1 1 1 1 0 0 0 0 0 15 0 0 0 2 4 2 2 2 0 0 0 2 2 2 0 0 0 0 2 2 2 1 
1 3 1 1 1 1 1 1 1 1 8 1 1 1 1 9 9 1 1 1 1 1 1 1 1 1 2 2 2 2 3 2 2 2 2 2 9 9 9 2 2 2 9 9 9 9 2 2 2 1 
