50
15
1
1
1 1 1 1 1 1 1 1 1 1 1 1 1 1 1 1 1 1 1 1 1 1 1 1 1 1 1 1 1 1 1 1 1 1 1 1 1 1 1 1 1 1 1 1 1 1 1 1 1 1 
1 0 0 0 0 0 0 0 0 0 0 0 0 0 0 0 0 0 0 0 0 0 0 1 0 0 0 0 0 0 0 0 0 0 0 0 0 0 0 0 0 0 0 0 0 0 0 0 0 1 
1 0 0 0 0 0 0 0 0 0 0 0 0 0 0 7 7 7 7 22 22 10 0 0 0 0 0 0 0 22 1 1 1 1 7 0 0 0 0 0 0 0 1 1 1 1 1 1 0 1 
1 0 0 0 0 0 0 0 0 0 0 0 0 0 7 1 1 1 1 1 1 1 1 1 1 1 0 0 1 1 1 0 0 0 1 0 0 1 22 1 0 0 1 0 0 0 0 0 0 1 
1 0 0 0 0 0 0 0 0 0 0 0 0 7 1 1 1 1 1 1 1 1 1 1 1 1 9 9 1 0 1 1 1 0 1 9 9 9 9 9 9 9 1 0 0 0 0 0 0 1 
1 0 0 0 0 0 0 0 0 0 0 0 7 1 1 1 1 1 1 1 1 1 1 1 1 1 1 1 1 0 0 0 0 0 1 1 1 1 1 1 1 1 1 0 1 1 1 1 1 1 
1 0 0 0 0 0 0 0 0 0 0 7 1 1 1 1 1 1 1 1 1 1 1 1 1 1 1 1 1 0 0 20 1 3 1 0 0 0 0 0 0 0 0 0 1 0 0 0 0 1 
1 0 0 0 0 0 0 0 0 0 7 1 1 1 1 1 0 0 0 0 0 0 0 0 1 1 1 1 1 16 1 1 1 1 1 1 0 0 1 1 1 1 1 1 1 0 0 0 0 1 
1 0 0 0 0 0 0 0 0 7 1 1 1 1 1 1 0 0 0 0 0 0 0 0 0 0 0 0 1 0 0 0 0 0 0 0 0 0 16 15 17 15 15 16 0 0 1 15 16 1 
1 0 0 0 0 0 0 0 7 1 1 1 1 1 1 1 0 0 1 7 22 0 0 1 1 1 0 4 1 3 0 0 1 8 1 0 0 0 15 16 15 17 16 15 0 0 1 16 15 1 
1 0 0 0 0 0 0 7 1 1 1 1 1 1 1 1 0 3 1 0 0 0 0 0 0 1 1 1 1 1 1 1 1 1 1 1 1 1 16 15 17 15 15 16 0 0 1 15 17 1 
1 0 0 0 0 0 7 1 1 1 1 1 1 1 1 1 0 0 0 0 0 0 0 19 0 0 0 0 15 0 0 0 0 0 17 0 0 1 1 1 1 1 1 1 1 1 1 17 16 1 
1 0 0 0 0 7 1 1 1 1 1 1 1 1 1 1 0 0 1 1 1 0 0 1 1 1 16 1 1 1 1 1 1 1 1 0 0 0 0 0 0 0 0 0 0 0 0 0 0 1 
1 0 21 0 7 1 1 1 1 1 1 1 1 1 1 1 3 0 1 1 1 9 9 1 0 0 0 1 17 0 0 0 0 0 16 0 0 0 0 21 0 0 0 0 0 0 19 0 0 1 
1 1 1 1 1 1 1 1 1 1 1 1 1 1 1 1 1 1 1 1 1 1 1 1 1 1 1 1 1 1 1 1 1 1 1 1 1 1 1 1 1 1 1 1 1 1 1 1 1 1 
